24 6
1 2 2 2 2 2 4 4 1 2 2 2 2 2 4 4 4 4 4 4 9 10 26 26 
5 6 5 5 5 5 2 2 5 6 5 5 5 5 2 2 2 2 3 3 14 15 26 26 
6 11 6 6 6 6 6 6 6 11 6 6 6 6 6 6 6 6 11 8 19 20 26 26 
12 16 7 12 12 7 12 7 12 16 7 12 12 7 12 7 7 8 16 18 24 25 26 26 
17 21 13 17 17 13 17 13 17 21 13 17 17 13 17 13 13 22 21 23 29 30 26 26 
26 26 26 26 26 26 26 26 26 26 26 26 26 26 26 26 26 26 26 26 26 26 26 26
160
192