88 6
1 52 21 3 2 52 21 3 2 52 23 3 2 52 21 3 14 52 21 40 2 2 2 2 52 25 50 52 11 2 2 14 52 40 52 40 52 40 52 2 40 2 17 17 2 50 52 78 76 91 105 56 105 84 84 84 61 91 61 105 105 84 84 109 2 1 52 11 2 52 40 2 52 21 19 81 71 72 52 73 71 72 52 73 71 23 40 80 
11 52 31 40 2 52 22 40 2 52 33 40 2 52 22 40 17 52 22 50 2 2 2 35 51 24 29 54 36 2 2 11 52 50 52 50 52 50 52 4 50 2 2 35 104 70 51 88 86 92 105 55 105 105 106 106 61 97 52 105 91 105 105 88 12 111 54 36 2 52 50 2 52 31 17 2 52 82 52 83 52 82 52 74 52 33 50 90 
2 52 34 50 2 52 32 50 3 52 22 50 2 52 32 50 2 52 22 50 2 35 42 45 53 15 7 53 46 47 12 104 52 50 52 50 52 50 52 14 50 2 44 45 15 15 67 79 96 93 93 53 105 37 95 94 107 101 63 105 38 108 98 64 26 15 67 46 47 54 70 104 54 103 2 2 52 2 52 2 52 2 52 14 52 34 28 100 
2 52 2 50 3 52 34 50 14 52 32 50 2 52 34 50 1 52 32 60 44 45 6 27 52 2 17 52 10 53 6 6 52 50 52 50 52 50 52 18 60 44 43 3 2 2 52 89 75 95 95 56 85 48 49 95 110 110 62 85 48 49 92 66 25 2 52 10 6 53 7 53 7 46 47 2 52 2 52 2 52 2 52 17 52 42 45 77 
12 51 12 70 13 51 12 12 5 51 24 70 12 51 12 70 11 51 24 42 43 16 13 12 51 12 12 51 12 51 13 13 51 70 51 70 51 70 51 13 42 43 16 13 12 12 51 99 75 37 105 55 95 51 68 69 110 110 55 39 51 68 69 65 24 12 51 12 13 51 17 51 17 20 58 47 51 12 51 12 51 12 51 12 51 30 16 87 
102 102 102 102 102 102 102 102 102 102 102 102 102 102 102 102 102 102 102 102 102 102 102 102 102 102 102 102 102 102 102 102 102 102 102 102 102 102 102 102 102 102 102 102 102 102 102 102 102 59 102 102 102 102 102 102 102 102 102 59 102 102 102 102 102 102 102 102 102 102 102 102 102 102 102 102 102 102 102 102 102 102 102 102 102 102 102 102
320 384